1111111111111
10010000000C1
1P00011E11001
1111111111111
1111111111111