1111111111111
1001002000CC1
1P00011E11001
1111111111111
1111111111111