1111111111111
1001000000CC1
1P00011E11021
1111111111111
1111111111111