1111111111111111111111111111111111
1P0000000000000C00000C000200000001
1010010100100000101001000000010101
1010010010101010001001000000010101
1EC0C0000C00C0000000000100000001C1
1111111111111111111111111111111111