1111111111111111111111111111111111
1P0000200002000C00000C000200000001
1010210100100200101001000000010101
1010010010101010001001002000010101
1EC0C0000C00C0002000000100020002C1
1111111111111111111111111111111111