1111111111111111111111
1P00000002000000002001
10000000CCC000CCCCCC01
1000000CCCC00CC00CCC01
100000CCCC000C000CCC01
10000CCCC00000000CCC01
1000CCCC02000000CCC001
100CCCC00002000CCC0001
10CCCC00000000CCC00001
10CCCCCCCCCC0CCCC00001
10CCCCCCCCCC0CCCC00C01
10CCCCCCCCCC0CCCC0CC01
100000000CCC0000000001
100002000CCC0000020001
100000000CCC0000000001
10200000000000000000E1
1111111111111111111111