1111111111111111111111
1C10201111101112101111
1010101111111111111011
1000000P00000000C21111
1211101011111010111211
1111111011101010201C11
1000111011111010111011
1C10101011111110101011
1110111010201C10111011
1200C00C101010000000E1
1111111111111111111111