111111111111111
1P00000E00000C1
111111111111111