1111111111111111
1P000C0000000001
1111000000000001
1000002000000001
1000111100011101
1000100200010001
1000100000010E01
1000000C00000001
1111111111111111